############################
#                          #
# ######################## #
# #                      # #
# #                      # #
# #         .            # #
# #                      # #
# #         P            # #
# #                      # #
#G#                      # #
# #                      # #
# #                      # #
# #                      # #
# ######################## #
#                          #
############################
