############################
#                          #
# ######################## #
# #                      # #
# #                      # #
# #         .            # #
# #         P            # #
# ######################## #
#                          #
#G######################## #
# #                      # #
# #                      # #
# #                      # #
# ######################## #
#                          #
############################
